,,,JJJJJ,JJJJJJ,JJJJJJ,JJ,,,,,,,,,,!!!,,,,,,,,
,,KKK,KKK,K  ,K,KKKKK,KKK, ,,,,,,,,  ,,  ,,,,,,
,,KKK,KKK,K  ,K,KKKK,, ,,,,,,,,  ,,  ,,,,,,
,,,KK&&,KKKK& && &,KKKK&&,,&,& &,&,,,,,,,  ,,  ,,,,,,
,,,,&&,,,,&,,,,,,,,,!,,,,,,,
,,,,,,,,,,,,,,,,,,,,,,,,
